derecho supletorio|derecho supletorio
centro formativo|centrar formativo
modificación|modificación
adopción|adopción
rescisión|rescisión
dietas y gastos|dieta y gasto
formación teórica|formación teórico
jornada|jornada
despido|despedir
pagaré|pagar
institución pública|institución público
exceder|exceder
concurrir|concurrir
asociación|asociación
período de prueba|período de probar
contaminación|contaminación
disposición legal|disposición legal
secretario judicial|secretario judicial
movimiento de consumidores|movimiento de consumidor
patrimonio|patrimonio
válido|válido
salario mínimo interprofesional|salariar mínimo interprofesional
derechos de los pasajeros|derecho de lo pasajero
espectáculo público|espectáculo público
jurisdicción|jurisdicción
extinción por voluntad del trabajador|extinción por voluntad del trabajador
renovación urbana|renovación urbano
extranjero|extranjero
descendiente|descendiente
jornada|jornada
refundido|refundir
análisis de coste-eficacia|análisis de coste eficacia
calidad del producto|calidad del producto
elementos personales|elemento personal
despido improcedente|despedir improcedente
máster|máster
cláusula|cláusula
jornada de trabajo|jornada de trabajar
autorización administrativa|autorización administrativo
comunidad de bienes|comunidad de bien
compensación económica|compensación económico
comisión mixta|comisión mixto
organismo público|organismo público
productividad|productividad
migración|migración
derecho de litigar|derecho de litigar
trabajo|trabajar
prevención|prevención
política pública|político público
grupo profesional |grupo profesional
incapacidad|incapacidad
funcionario público|funcionario público
permiso de maternidad|permiso de maternidad
convenio colectivo|convenio colectivo
derecho indisponible|derecho indisponible
administración|administración
principio de no discriminación|principiar de no discriminación
jornada reducida|jornada reducir
administración electrónica|administración electrónico
reclamable|reclamable
cómputo anual|cómputo anual
discriminación por razones de religión|discriminación por razonar de religión
contingencia común|contingencia común
acoso laboral|acosar laboral
duración de la conducción|duración de lo conducción
sentencia|sentenciar
seguridad social|seguridad social
trabajo dominical|trabajar dominical
acción|acción
publicidad abusiva|publicidad abusivo
sistema judicial|sistema judicial
horario|horario
falta de asistencia|falto de asistencia
negligencia|negligencia
administración institucional|administración institucional
asamblea de trabajadores|asamblea de trabajador
cotización del salario|cotización del salariar
acuerdo tácito|acordar tácito
sistema nacional de empleo|sistema nacional de emplear
riesgo|riesgo
operación mercantil|operación mercantil
turismo|turismo
víctima|víctima
ámbito territorial|ámbito territorial
Derecho de los consumidores|derecho de lo consumidor
ley de enjuiciamiento civil|ley de enjuiciamiento civil
aplicación|aplicación
entidad jurídica|entidad jurídico
hora extraordinaria|hora extraordinario
especialización profesional|especialización profesional
defensor judicial|defensor judicial
extinción del contrato|extinción del contratar
paro|parir
acuerdo interprofesional|acordar interprofesional
asalariado|asalariar
personal adscrito|personal adscribir
derecho de la seguridad social|derecho de lo seguridad social
administración central|administración central
sede de la administración|sedar de lo administración
concertación social|concertación social
costes ambientales|coste ambiental
rescindir|rescindir
profesión|profesión
indemnización|indemnización
pluriempleo|pluriempleo
discriminación por razones de estado civil|discriminación por razonar de estar civil
lugar de reunión|lugar de reunión
traslado|trasladar
contrato|contratar
flexibilidad|flexibilidad
permiso retribuido|permiso retribuir
domicilio legal|domiciliar legal
exclusión social|exclusión social
consejero|consejero
ausencia del trabajo|ausencia del trabajar
acción positiva|acción positivo
pacto|pactar
administración pública|administración público
pensionista|pensionista
profesión jurídica|profesión jurídico
medida|medir
contrato de interinidad|contratar de interinidad
sancionable|sancionable
constitucionalidad|constitucionalidad
movimiento social|movimiento social
responsabilidad|responsabilidad
descanso|descansar
puesto de trabajo|poner de trabajar
demanda|demandar
transcurso|transcurso
parque móvil|parque móvil
horario de trabajo|horario de trabajar
contrato de trabajo|contratar de trabajar
decisión unilateral|decisión unilateral
acto jurídico|acto jurídico
bienes y servicios|bien y servicio
trabajo a distancia|trabajar a distanciar
salario|salariar
principio de legalidad|principiar de legalidad
sindicación|sindicación
desempleo|desempleo
igualdad de remuneración por razón de sexo|igualdad de remuneración por razón de sexo
menor|menor
aprendizaje|aprendizaje
contrato público|contratar público
gratificación|gratificación
igualdad|igualdad
marco|marcar
contaminación de los alimentos|contaminación de lo alimento
sistema de alerta de la UE|sistema de alertar de lo ue
delegados de personal|delegar de personal
Red de Centros Europeos de los Consumidores|red de centro europeo de lo consumidor
información|información
convenio extraestatutario|convenio extraestatutario
incapacidad permanente|incapacidad permanente
comité de empresa|comité de empresa
derecho penitenciario|derecho penitenciario
contrato de relevo|contratar de relevar
comercio integrado|comerciar integrar
primacía del derecho|primacía del derecho
conflicto colectivo|conflicto colectivo
trabajo nocturno|trabajar nocturno
titulación|titulación
territorio español|territorio español
pronunciamiento|pronunciamiento
aprobación del presupuesto|aprobación del presupuestar
renta no salarial|rentar no salarial
origen|origen
salario mínimo interprofesional|salariar mínimo interprofesional
filosofía política|filosofía político
equipo de trabajo|equipar de trabajar
participación|participación
procedimiento judicial|procedimiento judicial
entidad del sector público|entidad del sector público
accidente|accidentar
despacho de abogados|despachar de abogar
autorizar|autorizar
economía|economía
Autoridad Europea de Seguros y Pensiones de Jubilación|autoridad europeo de seguro y pensionar de jubilación
formación profesional|formación profesional
administración local|administración local
integridad física|integridad físico
puerto de base|puerto de basar
tutela|tutelar
mano de obra|manir de obrar
norma administrativa|norma administrativo
unidad de negocio|unidad de negociar
discapacidad|discapacidad
grado medio|gradar mediar
jubilación parcial|jubilación parcial
dirección|dirección
prescripción de la pena|prescripción de lo penar
prestación|prestación
relación laboral especial|relación laboral especial
comisión|comisión
cometido|cometer
votación|votación
paternidad|paternidad
ejercicio individual|ejercicio individual
representante|representante
institución penitenciaria|institución penitenciario
trabajador|trabajador
capacidad profesional|capacidad profesional
discriminación directa|discriminación directo
internamiento|internamiento
derecho laboral|derecho laboral
oficina pública|oficina público
principio de jerarquía normativa|principiar de jerarquía normativo
tiempo parcial|tiempo parcial
concertación|concertación
título universitario|título universitario
oficina pública de empleo|oficina público de emplear
acuerdo por escrito|acordar por escribir
discriminación por razones de ideas políticas|discriminación por razonar de ideo político
ventura|venturo
órganos de administración de las empresas|órgano de administración de los empresa
jornada completa|jornada completo
acción de cesación|acción de cesación
organización|organización
accidente laboral|accidentar laboral
mancomunidad|mancomunidad
condiciones de trabajo|condicionar de trabajar
causas y efectos de la suspensión|causar y efecto de lo suspensión
extinción del contrato por causas objetivas|extinción del contratar por causar objetivo
reforma laboral|reformar laboral
abandono del trabajo|abandonar del trabajar
notario|notario
ámbito|ámbito
trabajo diurno|trabajar diurno
mérito|mérito
actividad por cuenta ajena|actividad por contar ajeno
trabajo de menores|trabajar de menor
pensión|pensión
registro administrativo|registrar administrativo
agente judicial|agente judicial
norma reglamentaria|norma reglamentario
vehículo comercial|vehículo comercial
ascendiente|ascendiente
comité de empresa europeo|comité de empresa europeo
capacidad jurídica|capacidad jurídico
titular|titular
consentimiento|consentimiento
gestión|gestión
autorización administrativa de la ett|autorización administrativo de lo ett
contrato fijo-discontinuo|contratar fijar discontinuo
norma de producción|norma de producción
instrumento internacional|instrumentar internacional
convocatoria|convocatorio
cumplimiento|cumplimiento
jubilado|jubilar
ámbito estatal|ámbito estatal
fondo de garantía salarial|fondo de garantir salarial
formación práctica|formación práctico
precepto|precepto
pariente|pariente
fallecimiento|fallecimiento
ámbito de aplicación|ámbito de aplicación
relación laboral|relación laboral
duración del contrato|duración del contratar
subsanación|subsanación
adjudicación|adjudicación
minusválido|minusválido
organización del trabajo|organización del trabajar
aval|aval
política de la vivienda|político de lo vivienda
medida cautelar|medir cautelar
criterio|criterio
legalidad|legalidad
norma estatuaria|norma estatuario
redistribución de la renta|redistribución de lo rentar
jurisdicción social|jurisdicción social
elaboración del Derecho de la UE|elaboración del derecho de lo ue
funcionario|funcionario
información al consumidor|información al consumidor
trabajo atípico|trabajar atípico
contratación|contratación
alta dirección|alto dirección
cláusula resolutoria|cláusula resolutorio
Notificación|notificación
pacto individual|pactar individual
ocupación|ocupación
transporte|transportar
Derecho mercantil|derecho mercantil
excedencia|excedencia
libre elección|librar elección
sindicalismo|sindicalismo
huelga|holgar
recluso|recluso
buena fe|bueno fe
plan de pensiones|plan de pensionar
análisis de políticas|análisis de político
desempeño|desempeñar
sigilo profesional|sigilar profesional
transferencia de la empresa|transferencia de lo empresa
cónyuge colaborador|cónyuge colaborador
procedimiento concursal|procedimiento concursal
discriminación|discriminación
conducta|conducta
declaración de nulidad|declaración de nulidad
hora complementaria|hora complementario
Derecho de la vivienda|derecho de lo vivienda
contractual|contractual
conducta sancionable|conducta sancionable
directivo|directivo
elección|elección
cuidado de la salud|cuidar de lo salud
servicio retribuido|servicio retribuir
aplicar|aplicar
remuneración|remuneración
mandato|mandato
ley|ley
instrumento jurídico intergubernamental|instrumentar jurídico intergubernamental
representación legal|representación legal
trabajos realizados a título de amistad|trabajo realizar a título de amistar
formación|formación
abuso|abusar
política salarial|político salarial
trabajador con discapacidad|trabajador con discapacidad
reglamentación técnica|reglamentación técnico
texto refundido|texto refundir
indemnización del seguro|indemnización del seguro
asesor jurídico|asesor jurídico
acción de nulidad|acción de nulidad
conflicto laboral|conflicto laboral
rescindir un contrato|rescindir uno contratar
improcedente|improcedente
benevolencia|benevolencia
análisis|análisis
equipo informático|equipar informático
plan de pensiones|plan de pensionar
acoso|acosar
responsabilidad penal|responsabilidad penal
principio de quien contamina paga|principiar de quien contaminar pagar
Prevención de riesgos laborales|prevención de riesgo laboral
hipoteca|hipotecar
ejercicio profesional|ejercicio profesional
persona jubilada|personar jubilar
actividad laboral|actividad laboral
publicidad|publicidad
hogar familiar|hogar familiar
forma del contrato|formar del contratar
pensión complementaria|pensión complementario
condición social|condición social
doctorado|doctorar
cualificación|cualificación
antigüedad|antigüedad
profesión artística|profesión artístico
salud pública|salud público
régimen|régimen
licencia|licenciar
persona jurídica|personar jurídico
crédito|crédito
seguridad y salud en el trabajo|seguridad y salud en el trabajar
asociación internacional de la seguridad social|asociación internacional de lo seguridad social
capacidad para contratar|capacidad parir contratar
sindicato|sindicato
condición|condición
ERE|erar
residencia|residenciar
problema social|problema social
crédito horario|crédito horario
compensación|compensación
contrato formativo|contratar formativo
categoría profesional|categoría profesional
gratificaciones extraordinarias|gratificación extraordinario
funcionario judicial|funcionario judicial
ampliación|ampliación
acción administrativa|acción administrativo
poder adquisitivo|poder adquisitivo
víctima de la violencia de género|víctima de lo violencia de género
centro de trabajo|centrar de trabajar
derecho de familia|derecho de familia
periodo de consultas|periodo de consultar
cónyuge|cónyuge
organismo|organismo
unilateral|unilateral
deber|deber
vigencia|vigencia
empresario|empresario
buena vecindad|bueno vecindad
alternancia|alternancia
adquisición|adquisición
medicamento falsificado|medicamento falsificar
autorización|autorización
patrimonio empresarial|patrimonio empresarial
concurrencia|concurrencia
derecho reconocido|derecho reconocer
capacidad procesal|capacidad procesal
renunciable|renunciable
supresión|supresión
despido procedente|despedir procedente
Derecho de las obligaciones|derecho de los obligación
real decreto|real decretar
indisponible|indisponible
subcontrata|subcontratar
ley orgánica|ley orgánico
órgano|órgano
mesa electoral|mesar electoral
disfrute de derechos|disfrutar de derecho
procedente|procedente
discriminación indirecta|discriminación indirecto
protección|protección
compra|comprar
autoridad laboral|autoridad laboral
autogobierno|autogobierno
orientación sexual|orientación sexual
sanción|sanción
turno de trabajo|turnar de trabajar
comisión parlamentaria|comisión parlamentario
cargo|cargar
fusión internacional|fusión internacional
impuesto|imponer
política|político
ocupación efectiva|ocupación efectivo
fines de semana|finar de semana
despido colectivo|despedir colectivo
prolongación|prolongación
autoridad|autoridad
empresa de trabajo temporal|empresa de trabajar temporal
ideas políticas|ideo político
condición favorable|condición favorable
calendario laboral|calendario laboral
órgano de administración|órgano de administración
responsabilidad del fabricante|responsabilidad del fabricante
movilidad funcional|movilidad funcional
aplicación del convenio colectivo|aplicación del convenio colectivo
legislación española laboral|legislación españolar laboral
convicción|convicción
cooperativa europea|cooperativo europeo
documento de sesión|documentar de sesión
seguridad|seguridad
jornada legal|jornada legal
remisión normativa|remisión normativo
industria sanitaria|industriar sanitario
sostenibilidad financiera|sostenibilidad financiero
trabajo efectivo|trabajar efectivo
institución|institución
periodo anual|periodo anual
amparo|amparar
contenido|contener
cobertura universal de enfermedad|cobertura universal de enfermedad
tramitación|tramitación
prestación de servicios|prestación de servicio
subcontratación|subcontratación
formación humana|formación humano
revistar|revistar
vivienda|vivienda
derecho civil|derecho civil
profesión administrativa|profesión administrativo
prórroga|prórroga
discriminación por razones de orientación sexual|discriminación por razonar de orientación sexual
liquidación|liquidación
derechos de información y consulta|derecho de información y consultar
lengua|lengua
incapacidad laboral|incapacidad laboral
jornada intensiva|jornada intensivo
contingencia|contingencia
religión|religión
conformidad|conformidad
cesión de trabajadores|cesión de trabajador
discriminación por razones de afiliación a un sindicato|discriminación por razonar de afiliación a uno sindicato
servicio laboral|servicio laboral
bienestar social|bienestar social
vacaciones|vacación
laguna legal|laguna legal
acuerdo de asociación|acordar de asociación
marco legal|marcar legal
centro especial de empleo|centrar especial de emplear
sector público|sector público
derecho básico|derecho básico
tercera edad|tercero edad
recurso colectivo|recurso colectivo
delegado|delegar
formación profesional continua|formación profesional continuo
visado|visar
acción por responsabilidad civil|acción por responsabilidad civil
promoción|promoción
cuantía|cuantiar
aplicación del derecho de la ue|aplicación del derecho de lo ue
comercio|comerciar
amparo de la ley|amparar de lo ley
revisión|revisión
maternidad|maternidad
ausencia|ausencia
organización de la enseñanza|organización de lo enseñanza
comercio al por menor|comerciar al por menor
horario flexible|horario flexible
defecto|defecto
reducción de jornada|reducción de jornada
tablón de anuncios|tablón de anuncio
ampliación de jornada|ampliación de jornada
indemnización por despido|indemnización por despedir
telecomunicación|telecomunicación
contrato indefinido|contratar indefinido
servicio|servicio
estatuto jurídico|estatuto jurídico
inobservancia|inobservancia
edad|edad
absorción de empresas|absorción de empresa
personal de alta dirección|personal de alto dirección
armonización de la seguridad social|armonización de lo seguridad social
discriminación por razones de discapacidad|discriminación por razonar de discapacidad
principio|principiar
empresa|empresa
usos y costumbres|uso y costumbre
acoso sexual|acosar sexual
validez|validez
concentración económica|concentración económico
ministerio fiscal|ministerio fiscal
estatuto|estatuto
producto originario|producto originario
duración|duración
recurso|recurso
procedimiento|procedimiento
dimisión|dimisión
legislación laboral|legislación laboral
comportamiento organizacional|comportamiento organizacional
cheque|cheque
abogado|abogar
distribución geográfica|distribución geográfico
administración regional|administración regional
movimientos de opinión|movimiento de opinión
concebido no nacido|concebir no nacer
legalidad procesal|legalidad procesal
consumidores|consumidor
comité|comité
falta de asistencia injustificada|falto de asistencia injustificado
cuantificable|cuantificable
restricción de la competencia|restricción de lo competencia
derecho|derecho
derogación|derogación
perjuicio|perjuicio
abuso de poder|abusar de poder
profesión liberal|profesión liberal
ampliación de vacaciones|ampliación de vacación
término|término
centro especial|centrar especial
subsistencia|subsistencia
remuneración pactada|remuneración pactar
publicidad de los precios|publicidad de lo precio
Peligro|peligrar
transferencias sociales|transferencia social
Intimidad|intimidar
condición de jubilación|condición de jubilación
discriminación por razones de condición social|discriminación por razonar de condición social
productividad del trabajo|productividad del trabajar
prescripción|prescripción
jubilación|jubilación
movilidad geográfica|movilidad geográfico
mutuo acuerdo|mutuo acordar
asesor fiscal|asesor fiscal
violencia política|violencia político
suspensión del contrato|suspensión del contratar
obligación|obligación
trabajo familiar|trabajar familiar
trabajo sedentario|trabajar sedentario
afinidad|afinidad
sucesión de empresa|sucesión de empresa
comportamiento político|comportamiento político
admisión|admisión
derecho necesario|derecho necesario
transferencia de derechos de pensión|transferencia de derecho de pensión
anticipos|anticipo
prorrogar|prorrogar
libre circulación de personas|librar circulación de personar
deberes laborales|deber laboral
reunión|reunión
contraprestación|contraprestación
horario de verano|horario de verano
ascenso|ascenso
comercializador|comercializador
instrucción|instrucción
cotización social|cotización social
seguridad en el trabajo|seguridad en el trabajar
transferencia|transferencia
sistema educativo|sistema educativo
garantías del salario|garantir del salariar
discriminación por razones de origen étnico|discriminación por razonar de origen étnico
por cuenta ajena|por contar ajeno
modificación colectiva|modificación colectivo
contrato a tiempo parcial|contratar a tiempo parcial
medida oportuna|medir oportuno
interés colectivo|interés colectivo
prestación social|prestación social
origen étnico|origen étnico
artesano|artesano
disposiciones reglamentarias|disposición reglamentario
admisibilidad|admisibilidad
requisito|requerir
origen racial|origen racial
cualificación profesional|cualificación profesional
persona contratada|personar contratar
aplicación del convenio|aplicación del convenio
consanguinidad|consanguinidad
paraíso fiscal|paraíso fiscal
comunidad intermunicipal|comunidad intermunicipal
periodo correspondiente|periodo correspondiente
norma social|norma social
discriminación por razones de edad|discriminación por razonar de edad
complemento salarial|complementar salarial
Organismo autónomo|organismo autónomo
jornada ordinaria|jornada ordinario
profesión independiente|profesión independiente
estatuto jurídico europeo|estatuto jurídico europeo
transferencia de capitales|transferencia de capital
absolución|absolución
sexo|sexo
nulidad|nulidad
renta complementaria|rentar complementario
autónomo|autónomo
discriminación por razones de convicciones|discriminación por razonar de convicción
usuarios|usuario
gestoría|gestoría
computar|computar
demandante|demandante
personalidad jurídica|personalidad jurídico
derechos básicos|derecho básico
negociación colectiva|negociación colectivo
trabajador autónomo|trabajador autónomo
tutela administrativa|tutelar administrativo
elaboración de políticas|elaboración de político
acción protectora|acción protector
discriminación por razones de origen racial|discriminación por razonar de origen racial
derecho económico|derecho económico
prima salarial|primo salarial
precepto jurídico|precepto jurídico
sistema de clasificación profesional|sistema de clasificación profesional
cooperación|cooperación
legitimación|legitimación
discriminación por razones de sexo|discriminación por razonar de sexo
legislación|legislación
jornada especial|jornada especial
limitación|limitación
representación del personal|representación del personal
modificación sustancial|modificación sustancial
estado civil|estar civil
anualidad|anualidad
gestor|gestor
competencia|competencia
protección del consumidor|protección del consumidor
comunidad|comunidad
conflicto|conflicto
fraude alimentario|fraude alimentario
dignidad|dignidad
retención|retención
horario|horario
pariente por consanguinidad|pariente por consanguinidad
diligencia|diligenciar
adopción de medidas cautelares|adopción de medir cautelar
pacto de no concurrencia|pactar de no concurrencia
operación|operación
marco común de referencia|marcar común de referenciar
facultad|facultar
lícito|lícito
amortización|amortización
afiliación a un sindicato|afiliación a uno sindicato
crédito salarial|crédito salarial
acción social|acción social
hora ordinaria|hora ordinario
mandato electoral|mandato electoral
tiempo de descanso|tiempo de descansar
exigencia|exigencia
acumulación de pensiones|acumulación de pensionar
discriminación por razones de lengua|discriminación por razonar de lengua
grado superior|gradar superior
modificación individual|modificación individual
promoción económica|promoción económico
remisión|remisión
marco europeo|marcar europeo
rescisión del contrato|rescisión del contratar
cesión|cesión
renta|rentar
colectivo|colectivo
subsidio|subsidiar
política cultural|político cultural
objeto lícito|objetar lícito
estatuto de los trabajadores|estatuto de lo trabajador
cotización|cotización
abogacía|abogacía
salario mínimo|salariar mínimo
supresión de empleo|supresión de emplear
suspensión|suspensión
asociación sectores público y privado|asociación sector público y privar
trabajo escolar|trabajar escolar
comisión negociadora|comisión negociador
hogar|hogar
fiestas|fiesta
interrupción|interrupción
personal|personal
grado|gradar
remuneración en especie|remuneración en especie
permiso|permiso
restricción|restricción
readmisión|readmisión
periodo|periodo
aceptación|aceptación
reclamación|reclamación
unidad productiva|unidad productivo
despido disciplinario|despedir disciplinario
seguridad del producto|seguridad del producto
propuesta de modificación|proponer de modificación
modificacion|modificacion
mod|mod
adopcion|adopcion
filiación adoptiva|filiación adoptivo
gastos de viaje|gasto de viajar
trabajo a media jornada|trabajar a medio jornada
día laborable|día laborable
certificado de depósito|certificar de depósito
pagare|pagar
organismo público de España|organismo público de españa
organismo público|organismo público
organismo publico|organismo publicar
organismo público (España)|organismo público   españa
sociedad|sociedad
unión|unión
corporación|corporación
cooperativa|cooperativo
período de prácticas|período de práctico
coste de los daños medioambientales|coste de lo daño medioambiental
Vertidos toxicos|vertido toxicos
Contaminante|contaminante
La contaminacion|lo contaminacion
Contaminado|contaminar
La contaminación|lo contaminación
Emision contaminante|emision contaminante
Contaminacion ambiental|contaminacion ambiental
Contaminada|contaminar
Contaminar|contaminar
Contaminacion|contaminacion
Polucion|polucion
Contaminación ambiental|contaminación ambiental
Vertidos tóxicos|vertido tóxico
Polución|polución
Emisión contaminante|emisión contaminante
actuario|actuario
organización de consumidores|organización de consumidor
salvaguardia del patrimonio cultural|salvaguardia del patrimonio cultural
SMI|smi
indicador de rendimiento clave|indicador de rendimiento clavar
derechos de los pasajeros de tren|derecho de lo pasajero de tren
sistema jurisdiccional|sistema jurisdiccional
competencia judicial|competencia judicial
revitalización urbana|revitalización urbano
extranjeros|extranjero
extranjera|extranjero
jornada de trabajo|jornada de trabajar
día laborable|día laborable
jornada laboral|jornada laboral
eficacia en función de los costes|eficacia en función de lo coste
criterio de calidad|criterio de calidad
jornada laboral|jornada laboral
Sociedad conyugal|sociedad conyugal
entidad de derecho público|entidad de derecho público
organismo de Derecho público|organismo de derecho público
organismo publico|organismo publicar
organismo público de España|organismo público de españa
organismo público (España)|organismo público   españa
productividad biológica|productividad biológico
repatriado|repatriar
reunificación familiar|reunificación familiar
migratorio|migratorio
migraciones|migración
migración interna|migración interno
tasa de migración|tasar de migración
migración elegida|migración elegir
nuevo asentamiento|nuevo asentamiento
estadísticas de asilo|estadístico de asilar
migración estacional|migración estacional
migración de trabajo|migración de trabajar
migratoria|migratorio
migración clandestina|migración clandestino
emigra|emigrar
migrante comunitario|migrante comunitario
migracion|migracion
mujer migrante|mujer migrante
éxodo rural|éxodo rural
trayecto domicilio-trabajo|trayecto domiciliar trabajar
derecho de recurso|derecho de recurso
empleo|emplear
política gubernamental|político gubernamental
políticas públicas|político público
incapacidad civil|incapacidad civil
incapacidad contractual|incapacidad contractual
servidor público|servidor público
cargo público|cargar público
funcionario publico|funcionario publicar
permiso por maternidad|permiso por maternidad
acuerdo colectivo|acordar colectivo
ubicación del organismo público|ubicación del organismo público
administración digital|administración digital
acoso moral en el trabajo|acosar moral en el trabajar
hostigamiento laboral|hostigamiento laboral
violencia psicológica en el trabajo|violencia psicológico en el trabajar
mobbing|mobbing
vía ejecutiva|vía ejecutivo
sentencia judicial|sentenciar judicial
juicio|juicio
protección social|protección social
seguro social|seguro social
sistema de previsión social|sistema de previsión social
previsión social|previsión social
trabajo en días no laborables|trabajar en día no laborable
programa de acción|programar de acción
publicidad engañosa|publicidad engañoso
publicidad falsa|publicidad falso
Riesgos|riesgo
Arriesgado|arriesgar
viaje por motivos de salud|viajar por motivo de salud
turismo ético|turismo ético
turismo náutico|turismo náutico
turismo de congresos|turismo de congreso
vacaciones en el campo|vacación en el campar
turismo respetuoso del medio ambiente|turismo respetuoso del mediar ambientar
peregrinaje|peregrinaje
perjudicado|perjudicar
parte perjudicada|partir perjudicar
ámbito de aplicación territorial|ámbito de aplicación territorial
legislación en materia de protección de los consumidores|legislación en materia de protección de lo consumidor
derecho en materia de protección de los consumidores|derecho en materia de protección de lo consumidor
despliegue|desplegar
implementación|implementación
entidad legal|entidad legal
ente jurídico|ente jurídico
hora extra|hora extra
reciclaje de conocimientos|reciclaje de conocimiento
extinción de la relación laboral|extinción de lo relación laboral
despido|despedir
índice de desempleo|índice de desempleo
trabajador asalariado|trabajador asalariar
ubicación del organismo público|ubicación del organismo público
coste ecológico|coste ecológico
carrera profesional|carrera profesional
profesiones|profesión
profesion|profesion
actividad complementaria|actividad complementario
cambio de puesto|cambiar de poner
cambio de lugar de trabajo|cambiar de lugar de trabajar
contrato laboral|contratar laboral
contrato por internet|contratar por internet
acuerdo|acordar
convenio|convenio
marginación social|marginación social
miembro del Consejo de Gobierno|miembro del consejo de gobernar
trabajador por cuenta propia|trabajador por contar propio
conseller|conseller
ministro|ministro
ausencia|ausencia
Administración del Estado|administración del estar
Gestion publica|gestion publicar
Administración publica|administración publicar
Oficinas publicas|oficina publicar
Administracion pública|administracion público
Oficinas públicas|oficina público
Gestión pública|gestión público
Gestión publica|gestión publicar
Gestion pública|gestion público
Administraciones públicas|administración público
Administracion del Estado|administracion del estar
Administracion publica|administracion publicar
Administraciones publicas|administración publicar
rentista|rentista
retirado|retirar
jubilado|jubilar
procurador|procurador
unidad de medida|unidad de medir
trabajo interino|trabajar interino
movimientos sociales|movimiento social
responsabilidad por los daños ecológicos|responsabilidad por lo daño ecológico
responsabilidad pública|responsabilidad público
responsabilidad legal|responsabilidad legal
responsabilidad medioambiental de la empresa|responsabilidad medioambiental de lo empresa
utilización pacífica del espacio|utilización pacífico del espaciar
sociedad limitada|sociedad limitar
responsabilidad del Gobierno|responsabilidad del gobernar
minoría de edad en Derecho penal|minoría de edad en derecho penal
responsabilidad de la administración pública|responsabilidad de lo administración público
responsabilidad por vicios ocultos|responsabilidad por vicio oculto
acción por daños y perjuicios|acción por daño y perjuicio
pausa|pausar
recreo|recrear
baja|bajo
ausencia|ausencia
puesto de trabajo de proceso de datos|poner de trabajar de procesar de dato
escrito de recurso|escribir de recurso
parque automovilístico|parque automovilístico
hora de trabajo|hora de trabajar
acto legal|acto legal
acto jurídico de la Unión|acto jurídico de lo unión
accion legal|accion legal
acción judicial|acción judicial
acción legal|acción legal
bienes fisicos y servicios intangibles|bien fisicos y servicio intangible
bienes físicos y servicios intangibles|bien físico y servicio intangible
teletrabajo|teletrabajo
Remuneración salarial|remuneración salarial
salario-hora profesional|salariar hora profesional
Salarial|salarial
tarifa de salarios|tarifar de salario
sueldo|soldar
jornal|jornal
nómina|nómina
salario móvil|salariar móvil
honorarios|honorario
Estipendio|estipendiar
salario por unidad de obra|salariar por unidad de obrar
subsidio de paro|subsidiar de parir
falta de trabajo|falto de trabajar
tasa de desempleo|tasar de desempleo
desocupacion|desocupacion
desocupación|desocupación
cesantia|cesantia
paro forzoso|parir forzoso
cesantía|cesantía
igualdad salarial|igualdad salarial
igualdad de salario|igualdad de salariar
técnica de aprendizaje|técnico de aprendizaje
aprender|aprender
objeto del contrato|objetar del contratar
sobresueldo|sobresueldo
propina|propinar
markka|markka
merk|merk
marc|marc
marka|marka
trama|tramar
mark|mark
contaminación alimentaria|contaminación alimentario
sistema de alerta rápida de la UE|sistema de alertar rápido de lo ue
representante de personal|representante de personal
representante sindical|representante sindical
Red para la solución extrajudicial de litigios de consumo|red parir lo solución extrajudicial de litigio de consumir
educación del consumidor|educación del consumidor
datos|dato
informacion|informacion
información policial confidencial|información policial confidencial
convenio irregular|convenio irregular
convenio colectivo extraestatutario|convenio colectivo extraestatutario
contrato colectivo extraestatutario|contratar colectivo extraestatutario
conflicto salarial|conflicto salarial
valoración volumétrica|valoración volumétrico
análisis volumétrico|análisis volumétrico
valoración química|valoración químico
Valoracion química|valoracion químico
valoración|valoración
volumetría|volumetría
Titracion|titracion
Valoracion volumetrica|valoracion volumetrica
Titulacion|titulacion
titración|titración
porcentaje|porcentaje
salario garantizado|salariar garantizar
salario mínimo|salariar mínimo
Filosofia Politica|filosofia politica
Filosofia Política|filosofia político
teoría política|teoría político
ente del sector público|ente del sector público
Probar con ejemplo|probar con ejemplo
cobertura de riesgos de accidente|cobertura de riesgo de accidentar
falacia dicto simpliciter|falacia dictar simpliciter
Accidente falacia|accidentar falacia
EIOPA|eiopa
formación preprofesional|formación preprofesional
administracion local|administracion local
autoridad local|autoridad local
puerto de origen|puerto de origen
tutela legal|tutelar legal
unidad empresarial|unidad empresarial
Direccion|direccion
rehabilitación|rehabilitación
ejercicio de actuaciones judiciales|ejercicio de actuación judicial
intervención del fiscal|intervención del fiscal
acción penal|acción penal
puesta en servicio|poner en servicio
delegación|delegación
comisión|comisión
función|función
voto electrónico|votar electrónico
votación secreta|votación secreto
voto|votar
voto por procuración|votar por procuración
votación del presupuesto|votación del presupuestar
papeleta de voto|papeleta de votar
última vuelta electoral|último volver electoral
prisión de alta seguridad|prisión de alto seguridad
empleado|emplear
miembro del personal|miembro del personal
competencia profesional|competencia profesional
derecho del trabajo|derecho del trabajar
dedicación completa|dedicación completo
accidente de trabajo|accidentar de trabajar
accidentes del trabajo|accidente del trabajar
accidentes de trabajo|accidente de trabajar
cláusulas del contrato|cláusula del contratar
causa de la suspensión|causar de lo suspensión
despido objetivo|despedir objetivar
despido justificado|despedir justificar
absentismo laboral|absentismo laboral
ausencia de puesto de trabajo|ausencia de poner de trabajar
Notario público|notario público
fedatario público|fedatario público
notaria|notario
scope|scope
ámbito de una declaración|ámbito de uno declaración
ámbito de validez|ámbito de validez
ámbito de validez de una declaración|ámbito de validez de uno declaración
actividad asalariada|actividad asalariar
Pensión (hospedaje)|pensión   hospedaje
posada secreta|posar secreto
casa de huéspedes|casar de huésped
alguacil|alguacil
norma legal|norma legal
vehiculo comercial|vehicular comercial
incapacidad jurídica|incapacidad jurídico
Capacidad juridica|capacidad juridica
titular del cargo|titular del cargar
titular del derecho|titular del derecho
management|management
administración|administración
concurso-subasta|concursar subastar
licitación|licitación
convocatoria de ofertas|convocatorio de ofertar
concurso restringido|concursar restringir
concurso público|concursar público
subasta pública|subastar público
pliego de condiciones generales|plegar de condicionar general
expediente de licitación|expedientar de licitación
convocatoria de licitación|convocatorio de licitación
FOGASA|fogasa
defunción|defunción
muerte|muerte
vínculo laboral|vínculo laboral
relación de trabajo|relación de trabajar
rectificación|rectificación
corrección|corrección
enmienda|enmendar
modificación|modificación
reforma|reformar
poder adjudicador|poder adjudicador
trabajador minusválido|trabajador minusválido
fianza|fianza
aval bancario|aval bancario
avales|avalar
construcción de viviendas|construcción de vivienda
medida preventiva|medir preventivo
medida conservativa|medir conservativo
ilegalidad|ilegalidad
jurisdicción laboral|jurisdicción laboral
jurisdicción del orden social|jurisdicción del orden social
procedimiento legislativo de la Unión Europea|procedimiento legislativo de lo unión europeo
consumidor|consumidor
JRC|jrc
heterótrofo|heterótrofo
plan de acción en favor de los consumidores|plan de acción en favor de lo consumidor
educación del consumidor|educación del consumidor
Red para la solución extrajudicial de litigios de consumo|red parir lo solución extrajudicial de litigio de consumir
notificacion|notificacion
legislación comercial|legislación comercial
derecho mercantil|derecho mercantil
permiso por asuntos propios|permiso por asunto propio
movimiento sindical|movimiento sindical
sindicato obrero|sindicato obrero
huelgas|huelga
paro laboral|parir laboral
preso|preso
rectitud|rectitud
probidad|probidad
lealtad|lealtad
subsidio de vejez|subsidiar de vejez
procedimiento de quiebra|procedimiento de quebrar
Discriminación social|discriminación social
Discriminación de género|discriminación de género
Discriminador|discriminador
Discriminatorio|discriminatorio
código internacional de conducta|código internacional de conducta
comportamiento|comportamiento
disposición del contrato|disposición del contratar
cura médica|curar médico
un sistema de precios mínimos|uno sistema de precio mínimo
en sustitución de los contingentes|en sustitución de lo contingente
orden de pago|orden de pagar
libramiento|libramiento
libranza|libranza
procuración|procuración
ley marco|ley marcar
norma jurídica|norma jurídico
reforma de la ley|reformar de lo ley
ley constitutiva|ley constitutivo
recurso en interés de ley|recurso en interés de ley
redacción de la ley|redacción de lo ley
ley aplicable|ley aplicable
ley de patentes|ley de patente
propuesta de ley|proponer de ley
rechazo de la ley|rechazar de lo ley
orden ministerial|orden ministerial
infracción del código de tráfico|infracción del código de tráfico
finura milesimal|finura milesimal
interpretación judicial|interpretación judicial
norma|norma
vigencia de la ley|vigencia de lo ley
comentario sobre un texto legislativo|comentario sobrar uno texto legislativo
ley electoral nacional|ley electoral nacional
ley habilitante|ley habilitante
violación de la ley|violación de lo ley
retroactividad|retroactividad
representante legal|representante legal
representación jurídica|representación jurídico
educación|educación
enseñanza|enseñanza
aprendizaje|aprendizaje
trabajador minusválido|trabajador minusválido
consejero jurídico|consejero jurídico
conflicto salarial|conflicto salarial
examen|examen
evaluación|evaluación
estimación|estimación
apreciación|apreciación
enjuiciamiento|enjuiciamiento
valoración|valoración
soporte físico informático|soportar físico informático
subsidio de vejez|subsidiar de vejez
responsabilidad criminal|responsabilidad criminal
contaminador-pagador|contaminador pagador
Prevencion de riesgo laboral|prevencion de riesgo laboral
Prevencion de riesgos laborales|prevencion de riesgo laboral
Prevención de riesgo laboral|prevención de riesgo laboral
Higiene industrial|higiene industrial
Salud laboral|salud laboral
Seguridad laboral|seguridad laboral
hipotecas|hipotecar
credito hipotecario|credito hipotecario
gravamen|gravamen
contrato de hipoteca|contratar de hipotecar
préstamo hipotecario|préstamo hipotecario
crédito hipotecario|crédito hipotecario
hipotecaria|hipotecario
prestamo hipotecario|prestamo hipotecario
gravámen|gravámen
Derecho hipotecario|derecho hipotecario
hipotecar|hipotecar
hipotecario|hipotecario
pensionista|pensionista
publicitaria|publicitario
mensajes publicitarios|mensaje publicitario
diseno publictario|diseno publictario
spam|spam
advertising|advertising
hacer publico|hacer publicar
medidas de publicidad|medir de publicidad
diseno publicitario|diseno publicitario
publicidad falsa|publicidad falso
diseño publicitario|diseñar publicitario
reclamación (por mercancía defectuosa)|reclamación   por mercancía defectuoso
diseño publictario|diseñar publictario
publicitario|publicitario
hacer público|hacer público
mensajes comerciales|mensaje comercial
publicidad comercial|publicidad comercial
propaganda|propaganda
publicidades|publicidad
reclame|reclamar
complemento de jubilación|complementar de jubilación
doctorat|doctorat
título universitario|título universitario
Doctorado (Francia)|doctorar   francia
Antiguedad|antiguedad
Antiguedades|antiguedades
Antigüedades|antigüedad
artistico|artistico
artístico|artístico
artística|artístico
torero|torero
artistica|artistica
sanidad pública|sanidad público
alimento dietético|alimentar dietético
persona|personar
persona juridica|personar juridica
persona moral|personar moral
personas jurídicas|personar jurídico
personas juridicas|personar juridicas
compra a plazos|comprar a plazo
créditos|crédito
AISS|aiss
sindicato obrero|sindicato obrero
ERTE|erte
Expediente de Regulación de Empleo|expedientar de regulación de emplear
residencia principal|residenciar principal
descontento social|descontentar social
horas sindicales|hora sindical
crédito de horas|crédito de hora
contrato para la formación|contratar parir lo formación
contrato de formación|contratar de formación
paga extra|pagar extra
pago adicional|pagar adicional
paga extraordinaria|pagar extraordinario
tarjeta gráfica|tarjeta gráfico
poder de compra|poder de comprar
lugar de trabajo|lugar de trabajar
puesto de trabajo|poner de trabajar
Family Law|family law
derecho familiar|derecho familiar
Derecho de las familias|derecho de los familia
marido|maridar
cumplimiento de la ley|cumplimiento de lo ley
desarrollo de la ley|desarrollar de lo ley
ejecución de la ley|ejecución de lo ley
contratista|contratista
industrial|industrial
patrono|patrono
patrón|patrón
parte contratante|partir contratante
oferta pública de intercambio|ofertar público de intercambiar
medicamento falso|medicamento falso
permiso|permiso
consentimiento|consentimiento
aprobación|aprobación
beneplácito|beneplácito
licencia|licenciar
aceptación|aceptación
obligación civil|obligación civil
Ley organica|ley organica
ley reguladora de los órganos del Estado|ley regulador de lo órgano del estar
oficina electoral|oficina electoral
local electoral|local electoral
aislamiento de huecos|aislamiento de hueco
cavidades|cavidad
adquisición|adquisición
estatuto de autonomía|estatuto de autonomía
turno|turnar
subcomisión parlamentaria|subcomisión parlamentario
comision parlamentaria|comision parlamentario
tributo|tributar
Politica|politica
continuación|continuación
extensión|extensión
desviación de poder|desviación de poder
ETT|ett
calendario de trabajo|calendario de trabajar
responsabilidad de productor|responsabilidad de productor
responsabilidad por vicios ocultos|responsabilidad por vicio oculto
S Coop.|segundo coop
Coop|coop
Cooperativas|cooperativo
sociedad cooperativa europea|sociedad cooperativo europeo
bodega cooperativa|bodega cooperativo
sociedad cooperativa|sociedad cooperativo
cooperativa|cooperativo
S.Coop.|segundo coop
Sociedad Cooperativa|sociedad cooperativo
S Coop|segundo coop
Sociedades cooperativas|sociedad cooperativo
semana de x horas|semana de x hora
ocupación efectiva|ocupación efectivo
Institucion|institucion
Institucional|institucional
Instituciones|institución
range|range
fuerza|forzar
alcance|alcanzar
cobertura sanitaria universal|cobertura sanitario universal
edificación habitable|edificación habitable
alojamiento|alojamiento
Derecho común|derecho común
conformismo|conformismo
viejo|viejo
sistema de reparación colectiva|sistema de reparación colectivo
delegada|delegar
formación permanente|formación permanente
visado turístico|visar turístico
visa|visar
cantidad|cantidad
monto|montar
importe|importar
aplicación del Derecho de la Unión Europea|aplicación del derecho de lo unión europeo
pequeño comerciante|pequeño comerciante
parto|partir
ventas al por menor|venta al por menor
venta al detalle|venta al detallar
comercio minorista|comerciar minorista
ventas al detalle|venta al detallar
venta al por menor|venta al por menor
horario variable|horario variable
jornada reducida|jornada reducir
reducción del tiempo de trabajo|reducción del tiempo de trabajar
reducción del trabajo|reducción del trabajar
reducción de jornada laboral|reducción de jornada laboral
fibra óptica|fibra óptico
satélite europeo de comunicaciones|satélite europeo de comunicación
tecnología de las telecomunicaciones|tecnología de los telecomunicación
telecomunicación sin hilos|telecomunicación sin hilo
Telecomunicacion|telecomunicacion
banda ancha|banda ancho
servicio económico|servicio económico
servicio economico|servicio economico
personalidad jurídica|personalidad jurídico
incumplimiento|incumplimiento
fusión de empresas|fusión de empresa
armonización de los regímenes de seguridad social|armonización de lo régimen de seguridad social
firma|firmar
normas consuetudinarias|norma consuetudinario
fueros y costumbres|fuero y costumbre
vigencia|vigencia
concentración de sociedades|concentración de sociedad
ministerio público fiscal|ministerio público fiscal
reglamento|reglamentar
duracion|duracion
vida|vida
atención a personas dependientes|atención a personar dependiente
acción para entablar recurso|acción parir entablar recurso
demanda de recurso|demandar de recurso
vía de revisión|vía de revisión
Licenciado|licenciar
letrado|letrado
licenciado en derecho|licenciar en derecho
abogados|abogar
abogada|abogar
abogadas|abogar
Licenciada|licenciar
organismo regional|organismo regional
movimientos políticos y sociales|movimiento político y social
economato|economato
organización de consumidores|organización de consumidor
legislación en materia de protección de los consumidores|legislación en materia de protección de lo consumidor
plan de acción en favor de los consumidores|plan de acción en favor de lo consumidor
política de consumo|político de consumir
procedimiento de comité|procedimiento de comité
práctica comercial restrictiva|práctico comercial restrictivo
desviación de poder|desviación de poder
servicios profesionales|servicio profesional
ampliación del periodo de vacaciones|ampliación del periodo de vacación
marcación de precios|marcación de precio
indicación del precio|indicación del preciar
ingresos sociales|ingreso social
edad de jubilación|edad de jubilación
rendimiento tipo|rendimiento tipo
normas de conducta|norma de conducta
asesor de impuestos|asesor de impuesto
asesor tributario|asesor tributario
revolución|revolución
excedencia|excedencia
suspensión del contrato laboral|suspensión del contratar laboral
interrupción de la actividad profesional|interrupción de lo actividad profesional
afiliación|afiliación
práctica política|práctico político
transferencia de los derechos de pensión|transferencia de lo derecho de pensión
transferencia de los derechos a pensión|transferencia de lo derecho a pensión
reunion|reunion
promoción|promoción
comercializadora|comercializador
compañía comercializadora|compañía comercializador
disposición|disposición
reglamento|reglamentar
ordenanza|ordenanza
cuota de la seguridad social|cuota de lo seguridad social
seguridad del trabajador|seguridad del trabajador
seguridad laboral|seguridad laboral
seguridad en el lugar de trabajo|seguridad en el lugar de trabajar
riesgo profesional|riesgo profesional
transferencia directa|transferencia directo
transconexión|transconexión
cesión de derecho|cesión de derecho
conexión en transferencia|conexión en transferencia
cesion de derechos|cesion de derecho
sistema escolar|sistema escolar
medida apropriada|medir apropriada
interés difuso|interés difuso
asistencia social|asistencia social
prestación o transferencia social|prestación o transferencia social
pensión|pensión
reglamentaciones|reglamentación
procedencia|procedencia
incompetencia profesional|incompetencia profesional
calificación profesional|calificación profesional
Consanguineo|consanguineo
Consanguíneo|consanguíneo
Consanguineidad|consanguineidad
paraíso bancario|paraíso bancario
paraisos fiscales|paraisos fiscal
paraiso fiscal|paraiso fiscal
paraíso tributario|paraíso tributario
paraísos fiscales|paraíso fiscal
paraíso financiero|paraíso financiero
Norma|norma
Normas sociales|norma social
organización gubernamental|organización gubernamental
organismo autonomo|organismo autonomo
agencia estatal|agenciar estatal
organismo autonomo administrativo|organismo autonomo administrativo
agencia publica|agenciar publicar
organismo autónomo|organismo autónomo
organismo publico|organismo publicar
agencia gubernamental|agenciar gubernamental
organismo autónomo administrativo|organismo autónomo administrativo
organizacion gubernamental|organizacion gubernamental
agencia pública|agenciar público
servicios subcontratados|servicio subcontratar
trabajador por cuenta propia|trabajador por contar propio
transferencia monetaria|transferencia monetario
nulidad jurídica|nulidad jurídico
nulidad de los actos juridicos|nulidad de lo acto juridicos
nulidad de los actos jurídicos|nulidad de lo acto jurídico
recurso por incompetencia|recurso por incompetencia
nulidad juridica|nulidad juridica
renta accesoria|rentar accesorio
territorio bajo tutela|territorio bajar tutelar
Pacto o contrato colectivo|pactar o contratar colectivo
Negociacion colectiva|negociacion colectivo
Acuerdo de closed shop|acordar de closed shop
trabajador por cuenta propia|trabajador por contar propio
formulación de políticas|formulación de político
sobresueldo|sobresueldo
parte interesada|partir interesar
interés legítimo|interés legítimo
vertiente jurídica|vertiente jurídico
representación de los trabajadores|representación de lo trabajador
Marco Común Europeo de Referencia para las Lenguas|marcar común europeo de referenciar parir los lengua
competencia institucional CE|competencia institucional ce
política de competencia de la Unión Europea|político de competencia de lo unión europeo
competencia de la Unión Europea|competencia de lo unión europeo
competencias externas CE|competencia externo ce
competencia compartida|competencia compartir
competencia por razón de materia|competencia por razón de materia
incompetencia profesional|incompetencia profesional
práctica comercial restrictiva|práctico comercial restrictivo
Competencia económica|competencia económico
reglamentación de la competencia|reglamentación de lo competencia
competencia de apoyo|competencia de apoyar
dominio de las herramientas informáticas|dominio de los herramienta informático
competencia judicial|competencia judicial
Competencia economica|competencia economica
plan de acción en favor de los consumidores|plan de acción en favor de lo consumidor
cymuned|cymuned
Conflicto dramatico|conflicto dramatico
Conflicto dramático|conflicto dramático
dignidad humana|dignidad humano
retención fiscal en la fuente|retención fiscal en lo fuente
cláusula inhibitoria de la competencia|cláusula inhibitorio de lo competencia
MCR|mcr
Amortizada|amortizar
Amortizacion|amortizacion
Amortizar|amortizar
amortización industrial|amortización industrial
derecho al salario|derecho al salariar
permiso|permiso
fomento económico|fomentar económico
impulso económico|impulsar económico
remision|remision
cura|curar
precio de cesión|preciar de cesión
remuneración del capital|remuneración del capital
mercado de obligaciones|mercar de obligación
renta del ganadero|rentar del ganadero
renta por habitante|rentar por habitante
retribución del trabajo|retribución del trabajar
impuesto sobre la renta de sociedades|imponer sobrar lo rentar de sociedad
impuesto sobre la renta de las sociedades|imponer sobrar lo rentar de los sociedad
renta agrícola|rentar agrícola
renta de aduanas|rentar de aduanar
renta accesoria|rentar accesorio
IRPF|irpf
asignación de la renta|asignación de lo rentar
certificado representativo de acciones|certificar representativo de accionar
porcentaje|porcentaje
renta garantizada|rentar garantizar
declaración del patrimonio|declaración del patrimonio
sistema de reparación colectiva|sistema de reparación colectivo
ET|et
colegio de abogados|colegiar de abogar
salario minimo|salariar minimo
sueldo sujeto al índice del coste de la vida|soldar sujetar al índice del coste de lo vida
salario mínimo legal mensual vigente|salariar mínimo legal mensual vigente
sueldo mínimo|soldar mínimo
ingreso minimo mensual|ingresar minimo mensual
ingreso mínimo mensual|ingresar mínimo mensual
sueldo minimo|soldar minimo
salario minimo legal mensual vigente|salariar minimo legal mensual vigente
salario minimo interprofesional|salariar minimo interprofesional
remuneracion minima vital|remuneracion minima vital
remuneración mínima|remuneración mínimo
remuneracion minima|remuneracion minima
salario mínimo interprofesional|salariar mínimo interprofesional
remuneración mínima vital|remuneración mínimo vital
pérdida de empleo|pérdida de emplear
reducción del personal|reducción del personal
Verringerung der Belegschaft|verringerung der belegschaft
sociedad público-privada|sociedad público privar
Trabajos extraescolares|trabajo extraescolar
Trabajos escolares|trabajo escolar
Deberes escolares|deber escolar
Tarea escolar|tarea escolar
Trabajo extraescolar|trabajar extraescolar
unidad familiar|unidad familiar
familia|familia
fiesta oficial|fiesta oficial
paro de la producción|parir de lo producción
beneficio no pecuniario|beneficiar no pecuniario
restricción de una función|restricción de uno función
denuncia|denunciar
acción restitutoria|acción restitutorio
